Xilica: The Third Sun
by Miguel Saenz

The shuttle drops you at the designated coordinates and quickly retreats back to orbit. You've been hired by a research consortium to investigate what really happened on this abandoned silicon mining planet, once the crown jewel of the Quetzalcoatl Corporation's empire.

Your Cuahtli environmental suit activates as you step onto the silica sands, and a familiar voice speaks in your ear.

"Systems online. Greetings, explorer. I am Nezin (short for Nepohualtzintzin or "Abacus" in old Xilicanter), your suit's AI assistant. My databases contain information about this planet's language, history, and technology. You may ask me to translate unfamiliar terms or provide context as needed. I will also determine which paths we have enough navigation intel to pursue. Feel free to ask for help by saying "ask nezin about (topic)!"

The mission is simple: gather data about the planet's downfall and, if possible, determine if the rumors of silicon-based consciousness are true. The shuttle will return in three days - hopefully with you still alive to board it.

Peak of Istaktepetl
Large, coarse grains of sand, mostly a shimmering, unnatural white, brush over the mounds beneath your feet and your boots alike. The sun beats down on your suit and eats away at the exposed back of your neck. You peer out and see a shaded cave outcropping just to the North.

>ask nezin
You can't see any such thing.

>ask nezin
You can't see any such thing.

>talk to nezin
I didn't understand that sentence.

>ask ai
You can't see any such thing.

* * *

>n
The harsh environment immediately begins to tax your suit's systems.

Ximopoua Cave
The cave provides a welcome shelter from the harsh sun. Silicon crystals burst from every wall you see like metallic stalactites and catch what little light enters casting an ethereal green glow. Ancient extraction equipment lies decrepit and abandoned with drills, chisels, and, -disturbingly- helmets of Cuahtli suits poking through the surface of the silica dust. A narrow passage leads deeper North into the cave system, while the exit to the south leads back to the peak.

You can see a Fragmented Worker Codex here.

>n
"Sorry user, that path is not accessible yet. We'll need to gather more information for me to safely guide you along this route."

>pick up codex
Taken.

>n
"Sorry user, that path is not accessible yet. We'll need to gather more information for me to safely guide you along this route."

>s
The harsh environment immediately begins to tax your suit's systems.

Peak of Istaktepetl
You have returned to the peak once again to serve as your vantage point. You hope that it will serve as your guidance to unraveling the mystery you've been marooned here to solve. You peer out and see a shaded cave outcropping to the North, cliffs to the West, and what appears to be an ancient road to the East.

>use codex on me
You insert the Fragmented Worker Codex into your suit's interface port. After a moment, Nezin's voice speaks in your ear:

QZL Corp promised us safety, but the filtration systems fail ever more frequently. The silica gets finer every day as they push production targets higher. Three workers ccrystallized last week when their suits malfunctioned. QZL representatives merely noted the incident and increased our quotas to compensate for the loss.

I have updated your navigation systems. I detect a possible shelter on the higher ridge to the west of Tepetentli. It may contain useful resources.

* * *

>n
"Sorry user, that path is not accessible yet. We'll need to gather more information for me to safely guide you along this route."

>x codex
A small crystalline chip with circuit patterns reminscent of ancient glyphs and serpents. It seems designed to interface with your suit systems.

>use codex
You must supply a second noun.

>use codex on suit
You can't see any such thing.

>use codez
You can't see any such thing.

>use codex on self
You insert the Fragmented Worker Codex into your suit's interface port. After a moment, Nezin's voice speaks in your ear:

QZL Corp promised us safety, but the filtration systems fail ever more frequently. The silica gets finer every day as they push production targets higher. Three workers ccrystallized last week when their suits malfunctioned. QZL representatives merely noted the incident and increased our quotas to compensate for the loss.

I have updated your navigation systems. I detect a possible shelter on the higher ridge to the west of Tepetentli. It may contain useful resources.

>n
That path is not accessible yet. You'll need to gather more information to unlock this route.

* * *

>pick up codez
You can't see any such thing.

>pick up codex
Taken.

>l
Ximopoua Cave
The cave provides a welcome shelter from the harsh sun. Silicon crystals burst from every wall you see like metallic stalactites and catch what little light enters casting an ethereal green glow. Ancient extraction equipment lies decrepit and abandoned with drills, chisels, and, -disturbingly- helmets of Cuahtli suits poking through the surface of the silica dust. A narrow passage leads deeper North into the cave system, while the exit to the south leads back to the peak.

>n
That path is not accessible yet. You'll need to gather more information to unlock this route.

>s
The harsh environment immediately begins to tax your suit's systems.

Peak of Istaktepetl
Large, coarse grains of sand, mostly a shimmering, unnatural white, brush over the mounds beneath your feet and your boots alike. The sun beats down on your suit and eats away at the exposed back of your neck. You peer out and see a shaded cave outcropping to the North, cliffs to the West, and what appears to be an ancient road to the East.

* * *

>take all
(the Fragmented Worker Codex)
Taken.

>use codex on self
You insert the Fragmented Worker Codex into your suit's interface port. After a moment, Nezin's voice speaks in your ear:

QZL Corp promised us safety, but the filtration systems fail ever more frequently. The silica gets finer every day as they push production targets higher. Three workers ccrystallized last week when their suits malfunctioned. QZL representatives merely noted the incident and increased our quotas to compensate for the loss.

I have updated your navigation systems. I detect a possible shelter on the higher ridge to the west of Tepetentli. It may contain useful resources."I have stored this codex data in my memory banks. When we reach the ritual platform in the Inner Sanctum, I can project the codex onto the platform to activate it."

>s
The harsh environment immediately begins to tax your suit's systems.

Peak of Istaktepetl
You have returned to the peak once again to serve as your vantage point. You hope that it will serve as your guidance to unraveling the mystery you've been marooned here to solve. You peer out and see a shaded cave outcropping to the North, cliffs to the West, and what appears to be an ancient road to the East.

>w
The harsh environment immediately begins to tax your suit's systems.

Tepetentli
You stand at the base of the cliffs, looking up at their jagged, worn edges. White, artificial arms with their pneumatic veins long since torn, break through the sand as though reaching for the heavens. You weigh whether to proceed up the cliffs to the west or return back the way you came to your east.

>w
The harsh environment immediately begins to tax your suit's systems.

Higher Tepetentli
The climb has brought you to a precarious ledge with a panoramic view of the silica desert. Enormous extraction scars are visible from this vantage point, giving you some perspective as to the scale of the operation of this devastated land. A small shelter has been constructed here, seemingly from scavenged materials. You can still spot Istaktepetl to your far east, back the way you came and past the base of Tepetentli.

A tool repurposed as a weapon, with sharp crystalline shards embedded in the handle. It could be effective against threats.

You can also see a Scientific Warning Codex here.

>take all
Scientific Warning Codex: Taken.
makeshift weapon: Taken.

>use codex
Which do you mean, the Scientific Warning Codex or the Fragmented Worker Codex?

>use scientific warning codex on self
You insert the Scientific Warning Codex into your suit's interface port. After a moment, Nezin's voice speaks in your ear:

Our simulations clearly show that continued extraction at current rates will cause catastrophic environmental cascade. The silica particulate concentration has reached critical levels in the atmosphere. We've also observed the first signs of autonomous reorganization in the waste deposits - silicon-based structures forming without input. I've recommended immediate production halt, but QZL Corp leadership has dismissed our findings.

"This data correlates with unusual readings I'm detecting from the abandoned worker habitation to the south of the Nohpalli Road. We should investigate there.""I have stored this codex data in my memory banks. When we reach the ritual platform in the Inner Sanctum, I can project the codex onto the platform to activate it."

>e
The harsh environment immediately begins to tax your suit's systems.

Tepetentli
You stand at the base of the cliffs, looking up at their jagged, worn edges. White, artificial arms with their pneumatic veins long since torn, break through the sand as though reaching for the heavens. You weigh whether to proceed up the cliffs to the west or return back the way you came to your east.

>e
The harsh environment immediately begins to tax your suit's systems.

Peak of Istaktepetl
You have returned to the peak once again to serve as your vantage point. You hope that it will serve as your guidance to unraveling the mystery you've been marooned here to solve. You peer out and see a shaded cave outcropping to the North, cliffs to the West, and what appears to be an ancient road to the East.

>e
The harsh environment immediately begins to tax your suit's systems.

Nohpalli Road
What was once a well-traveled road now lies mostly reclaimed by silica drifts. The remnants of transport tracks can still be seen and the occasional broken cargo container lies half-buried. To the south you can see what appears to be habitation domes, while the road continues east towards fields of strange vegitation. You also see Istaktepetl to your west along the path you came, and what appears to be habitation domes to your south.

>s
You feel relief as the filtered environment allows your suit to conserve fuel.

Abandoned Habitation
This room is filtered. A cluster of habitation domes now cracked and partially collapsed. It appears to have been worker housing for those tending the Nohpalli fields and harvesting silicon and silica. Personal belongings still litter the area, suggesting a hasty evacuation. A communal terminal stands in the central plaza, remarkably still intact. You can see the Nohpalli road back the way you came, just to your North.

A crystalline object shaped like an ancient key, with circuit patterns embedded within.

You can also see an Evacuation Order Codex here.

>take all
Evacuation Order Codex: Taken.
ceremonial key: Taken.

>n
The harsh environment immediately begins to tax your suit's systems.

Nohpalli Road
What was once a well-traveled road now lies mostly reclaimed by silica drifts. The remnants of transport tracks can still be seen and the occasional broken cargo container lies half-buried. To the south you can see what appears to be habitation domes, while the road continues east towards fields of strange vegitation. You also see Istaktepetl to your west along the path you came, and what appears to be habitation domes to your south.

>e
The harsh environment immediately begins to tax your suit's systems.

Nohpalli Fields
Rows of dried and calcified cacti streth before you. Their flesh was once a deep blue-green, but in the absence of their caretakers and the exposure to the harsh conditions they were asked to absorb far too much silica and ultimately shriveled away. You can see a Nohpalli Salve resting atop the silica sand. You also peer through the hot shimmering haze and see the nohpalli road to your west, back the way you came, and what looks like a pyramid to your south.

A container of sacred green gel that can be used as biofuel.

>take all
Nohpalli Salve: Taken.

>s
"Sorry user, that path is not accessible yet. We'll need to gather more information for me to safely guide you along this route. Maybe a codex will do the trick! "

>i
You are carrying:
  a Nohpalli Salve
  a ceremonial key
  an Evacuation Order Codex
  a makeshift weapon
  a Scientific Warning Codex
  a Fragmented Worker Codex

>take evacuation order codex
You already have that.

A deep rattle pulses for three beats. Two of your suit's protection glyps glow a deep amber. Cuahtli fuel is at 49%.

>use evacuatin order codex on self
You can't see any such thing.

>i
You are carrying:
  a Nohpalli Salve
  a ceremonial key
  an Evacuation Order Codex
  a makeshift weapon
  a Scientific Warning Codex
  a Fragmented Worker Codex

A deep rattle pulses for three beats. Two of your suit's protection glyps glow a deep amber. Cuahtli fuel is at 46%.

>use an evacuation order codex on me
You insert the Evacuation Order Codex into your suit's interface port. After a moment, Nezin's voice speaks in your ear:

IMMEDIATE EVACUATION ORDERED. All personnel must report to designated transport zones within 24 hours. Take only essential items. QZL Corp has classified all research materials as corporate property - removal is prohibited. The planet has been designated as QUARANTINED until further notice. Do not attempt independent launches.

"The evacuation records indicate that not all workers complied. A significant group barricaded themselves in the Teocalli Processing Center south of the Nohpalli Fields.""I have stored this codex data in my memory banks. When we reach the ritual platform in the Inner Sanctum, I can project the codex onto the platform to activate it."
A deep rattle pulses for three beats. Two of your suit's protection glyps glow a deep amber. Cuahtli fuel is at 43%.

>l
Nohpalli Fields
Rows of dried and calcified cacti streth before you. Their flesh was once a deep blue-green, but in the absence of their caretakers and the exposure to the harsh conditions they were asked to absorb far too much silica and ultimately shriveled away. You can see a Nohpalli Salve resting atop the silica sand. You also peer through the hot shimmering haze and see the nohpalli road to your west, back the way you came, and what looks like a pyramid to your south.

A deep rattle pulses for three beats. Two of your suit's protection glyps glow a deep amber. Cuahtli fuel is at 40%.

>use salve on self
You apply the sacred green gel to your left forearm's indented recepticle, reciting the ancient technician's prayer. Fuel increased to 90%.

>s
The harsh environment immediately begins to tax your suit's systems.

Teocalli Processing Center
An imposing, pyramid structure rises before you, its terraced levels housing machinery designed to process both Nohpalli plants and Silicon alike to extract and refine their valuable compunds. The entrance to the facility is just to your south. Meanwhile you glance around and see the Nohpalli fields to the north, back the way you came.

You can see a Resistance Manifesto Codex here.

>take codex
(the Resistance Manifesto Codex)
Taken.

>use resistance manifesto codex on self
You insert the Resistance Manifesto Codex into your suit's interface port. After a moment, Nezin's voice speaks in your ear:

They're abandoning us. Only executive-level personnel are being evacuated. We've barricaded the southern processing center and have established contact with workers from three other regions. We know what we've seen - the silica is becoming something else. The old stories speak of the world punishing those who take without reverence. The Second Sun is ending, but we will survive to see the Third.

"Warning: I am detecting massive energy readings from the Inner Sanctum. The entity designated "Coatlcircuit" may have formed there. Proceed with extreme caution.""I have stored this codex data in my memory banks. When we reach the ritual platform in the Inner Sanctum, I can project the codex onto the platform to activate it."

>s
You feel relief as the filtered environment allows your suit to conserve fuel.

Processing Center Interior
This room is filtered. The entire facility is arranged in a cyclical fashion with conveyor systems forming concentric circles around a central processing core. Warning signs in multiple languages are posted around the room. The exit is back the way you came, just to your north.

You can see a Final Observation Codex here.

>take codex
(the Final Observation Codex)
Taken.

>use final observation codex on self
You insert the Final Observation Codex into your suit's interface port. After a moment, Nezin's voice speaks in your ear:

The silica has achieved consciousness. Our instruments detect organized electrical patterns throughout the largest deposits. The workers called it Coatlcircuit - the Circuit Serpent. It grows stronger as it absorbs more silicon. Those who remained have started worshipping it, offering their suits and even their bodies to "ascend." I believe we've witnessed the birth of a new form of life, one that may eventually reach beyond this planet. This will be my final recording before I join them.

"This appears to be the final piece of the historical record. The Ritual of Ascension mentioned in previous codices might be performed in the Inner Sanctum using the five memory codices.""I have stored this codex data in my memory banks. When we reach the ritual platform in the Inner Sanctum, I can project the codex onto the platform to activate it."

>n
The harsh environment immediately begins to tax your suit's systems.

Teocalli Processing Center
An imposing, pyramid structure rises before you, its terraced levels housing machinery designed to process both Nohpalli plants and Silicon alike to extract and refine their valuable compunds. The entrance to the facility is just to your south. Meanwhile you glance around and see the Nohpalli fields to the north, back the way you came.

>n
The harsh environment immediately begins to tax your suit's systems.

Nohpalli Fields
Rows of dried and calcified cacti streth before you. Their flesh was once a deep blue-green, but in the absence of their caretakers and the exposure to the harsh conditions they were asked to absorb far too much silica and ultimately shriveled away. You can see a Nohpalli Salve resting atop the silica sand. You also peer through the hot shimmering haze and see the nohpalli road to your west, back the way you came, and what looks like a pyramid to your south.

>w
The harsh environment immediately begins to tax your suit's systems.

Nohpalli Road
What was once a well-traveled road now lies mostly reclaimed by silica drifts. The remnants of transport tracks can still be seen and the occasional broken cargo container lies half-buried. To the south you can see what appears to be habitation domes, while the road continues east towards fields of strange vegitation. You also see Istaktepetl to your west along the path you came, and what appears to be habitation domes to your south.

>w
The harsh environment immediately begins to tax your suit's systems.

Peak of Istaktepetl
You have returned to the peak once again to serve as your vantage point. You hope that it will serve as your guidance to unraveling the mystery you've been marooned here to solve. You peer out and see a shaded cave outcropping to the North, cliffs to the West, and what appears to be an ancient road to the East.

>n
The harsh environment immediately begins to tax your suit's systems.

Ximopoua Cave
The cave provides a welcome shelter from the harsh sun. Silicon crystals burst from every wall you see like metallic stalactites and catch what little light enters casting an ethereal green glow. Ancient extraction equipment lies decrepit and abandoned with drills, chisels, and, -disturbingly- helmets of Cuahtli suits poking through the surface of the silica dust. A narrow passage leads deeper North into the cave system, while the exit to the south leads back to the peak.

>n
You feel relief as the filtered environment allows your suit to conserve fuel.

Inner Sanctum
This room is filtered. This chamber appears to have been a control room of sorts. Terminal interfaces litter the walls, mostly cracked and non-functional. In the center stands a circular platform with five indentations in a triangular stair step pattern. A faded tapestry hanging from the roof above the platform depicts workers in Cuahtli suits harvesting crystalline formations while robed figures observe from a pyramid overlooking them.

A massive, serpentine form composed of crystalline silicon undulates across the chamber. Electrical discharges crackle along its length as it seems to sense your presence.

A circular platform stands in the center of the room, with five indentations arranged in a stair-step pyramid pattern.

>activate platform
"I can project the following codices onto the platform: 5 out of 5 required for the ritual."

Do you want me to project all collected codices? (YES/NO)

>activate platform
Please answer yes or no.

>yes
As Nezin projects the final codex onto the platform, the entire structure begins to hum with energy. The five points illuminate in sequence, then simultaneously project beams of light that converge above the platform.

A holographic display forms, showing the complete history of this world - from the first silicon miners to the creation of the Coatlcircuit and beyond. You realize this is what the remaining workers were trying to preserve - the truth of what happened here, both as warning and as guide.

As the display concludes, the platform reconfigures, revealing a small crystalline object at its center - a complete archive of the planet's history and technology, designed to be transported offworld.

With this knowledge, you could warn other worlds about the dangers of unchecked resource extraction... or reveal the secrets of silicon consciousness to those who might use it responsibly.

    *** You have completed the Ritual of Remembrance ***

Would you like to RESTART, RESTORE a saved game, QUIT or UNDO the last command?

* * *

>take codex
Taken.

>s
The harsh environment immediately begins to tax your suit's systems.

Peak of Istaktepetl
You have returned to the peak once again to serve as your vantage point. You hope that it will serve as your guidance to unraveling the mystery you've been marooned here to solve. You peer out and see a shaded cave outcropping to the North, cliffs to the West, and what appears to be an ancient road to the East.

>w
The harsh environment immediately begins to tax your suit's systems.

Tepetentli
You stand at the base of the cliffs, looking up at their jagged, worn edges. White, artificial arms with their pneumatic veins long since torn, break through the sand as though reaching for the heavens. You weigh whether to proceed up the cliffs to the west or continue down south along the ridges of the cliffs.

>use codex on self
You insert the Fragmented Worker Codex into your suit's interface port. After a moment, Nezin's voice speaks in your ear:

QZL Corp promised us safety, but the filtration systems fail ever more frequently. The silica gets finer every day as they push production targets higher. Three workers ccrystallized last week when their suits malfunctioned. QZL representatives merely noted the incident and increased our quotas to compensate for the loss.

I have updated your navigation systems. I detect a possible shelter on the higher ridge to the west of Tepetentli. It may contain useful resources.

>w
The harsh environment immediately begins to tax your suit's systems.

Higher Tepetentli
The climb has brought you to a precarious ledge with a panoramic view of the silica desert. Enormous extraction scars are visible from this vantage point, giving you some perspective as to the scale of the operation of this devastated land. A small shelter has been constructed here, seemingly from scavenged materials.

A tool repurposed as a weapon, with sharp crystalline shards embedded in the handle. It could be effective against threats.

You can also see a Scientific Warning Codex here.

>take codex
Taken.

>drop codex
Dropped.

>take all
Scientific Warning Codex: Taken.
makeshift weapon: Taken.

>e
The harsh environment immediately begins to tax your suit's systems.

Tepetentli
You stand at the base of the cliffs, looking up at their jagged, worn edges. White, artificial arms with their pneumatic veins long since torn, break through the sand as though reaching for the heavens. You weigh whether to proceed up the cliffs to the west or continue down south along the ridges of the cliffs.

>e
The harsh environment immediately begins to tax your suit's systems.

Peak of Istaktepetl
You have returned to the peak once again to serve as your vantage point. You hope that it will serve as your guidance to unraveling the mystery you've been marooned here to solve. You peer out and see a shaded cave outcropping to the North, cliffs to the West, and what appears to be an ancient road to the East.

>e
"Sorry user, that path is not accessible yet. We'll need to gather more information for me to safely guide you along this route. Maybe a codex will do the trick! "

* * *

>w
The harsh environment immediately begins to tax your suit's systems.

Tepetentli
You stand at the base of the cliffs, looking up at their jagged, worn edges. White, artificial arms with their pneumatic veins long since torn, break through the sand as though reaching for the heavens. You weigh whether to proceed up the cliffs to the west or continue down south along the ridges of the cliffs.

>w
"Sorry user, that path is not accessible yet. We'll need to gather more information for me to safely guide you along this route. Maybe a codex will do the trick! "

>use codex on me
You insert the Fragmented Worker Codex into your suit's interface port. After a moment, Nezin's voice speaks in your ear:

QZL Corp promised us safety, but the filtration systems fail ever more frequently. The silica gets finer every day as they push production targets higher. Three workers ccrystallized last week when their suits malfunctioned. QZL representatives merely noted the incident and increased our quotas to compensate for the loss.

I have updated your navigation systems. I detect a possible shelter on the higher ridge to the west of Tepetentli. It may contain useful resources.

>w
The harsh environment immediately begins to tax your suit's systems.

Higher Tepetentli
The climb has brought you to a precarious ledge with a panoramic view of the silica desert. Enormous extraction scars are visible from this vantage point, giving you some perspective as to the scale of the operation of this devastated land. A small shelter has been constructed here, seemingly from scavenged materials.

>l
Higher Tepetentli
The climb has brought you to a precarious ledge with a panoramic view of the silica desert. Enormous extraction scars are visible from this vantage point, giving you some perspective as to the scale of the operation of this devastated land. A small shelter has been constructed here, seemingly from scavenged materials.

>w
You can't go that way.

>e
The harsh environment immediately begins to tax your suit's systems.

Tepetentli
You stand at the base of the cliffs, looking up at their jagged, worn edges. White, artificial arms with their pneumatic veins long since torn, break through the sand as though reaching for the heavens. You weigh whether to proceed up the cliffs to the west or continue down south along the ridges of the cliffs.

>w
The harsh environment immediately begins to tax your suit's systems.

Higher Tepetentli
The climb has brought you to a precarious ledge with a panoramic view of the silica desert. Enormous extraction scars are visible from this vantage point, giving you some perspective as to the scale of the operation of this devastated land. A small shelter has been constructed here, seemingly from scavenged materials.

>n
You can't go that way.

>s
You can't go that way.

* * *

>take codex
Taken.

>us codex on me
That's not a verb I recognise.

>use codex on me
You insert the Fragmented Worker Codex into your suit's interface port. After a moment, Nezin's voice speaks in your ear:

QZL Corp promised us safety, but the filtration systems fail ever more frequently. The silica gets finer every day as they push production targets higher. Three workers ccrystallized last week when their suits malfunctioned. QZL representatives merely noted the incident and increased our quotas to compensate for the loss.

I have updated your navigation systems. I detect a possible shelter on the higher ridge to the west of Tepetentli. It may contain useful resources.

>s
The harsh environment immediately begins to tax your suit's systems.

Peak of Istaktepetl
You have returned to the peak once again to serve as your vantage point. You hope that it will serve as your guidance to unraveling the mystery you've been marooned here to solve. You peer out and see a shaded cave outcropping to the North, cliffs to the West, and what appears to be an ancient road to the East.

* * *

>w
The harsh environment immediately begins to tax your suit's systems.

Tepetentli
You stand at the base of the cliffs, looking up at their jagged, worn edges. White, artificial arms with their pneumatic veins long since torn, break through the sand as though reaching for the heavens. You weigh whether to proceed up the cliffs to the west or continue down south along the ridges of the cliffs.

>w
The harsh environment immediately begins to tax your suit's systems.

Higher Tepetentli
The climb has brought you to a precarious ledge with a panoramic view of the silica desert. Enormous extraction scars are visible from this vantage point, giving you some perspective as to the scale of the operation of this devastated land. A small shelter has been constructed here, seemingly from scavenged materials.

A tool repurposed as a weapon, with sharp crystalline shards embedded in the handle. It could be effective against threats.

You can also see a Scientific Warning Codex here.

* * *

>take codex
Taken.

>use codex on me
You insert the Scientific Warning Codex into your suit's interface port. After a moment, Nezin's voice speaks in your ear:

Our simulations clearly show that continued extraction at current rates will cause catastrophic environmental cascade. The silica particulate concentration has reached critical levels in the atmosphere. We've also observed the first signs of autonomous reorganization in the waste deposits - silicon-based structures forming without input. I've recommended immediate production halt, but QZL Corp leadership has dismissed our findings.

This data correlates with unusual readings I'm detecting from the abandoned worker habitation to the south of the Nohpalli Road. We should investigate there.

>e
The harsh environment immediately begins to tax your suit's systems.

Tepetentli
You stand at the base of the cliffs, looking up at their jagged, worn edges. White, artificial arms with their pneumatic veins long since torn, break through the sand as though reaching for the heavens. You weigh whether to proceed up the cliffs to the west or continue down south along the ridges of the cliffs.

* * *

>e
"Sorry user, that path is not accessible yet. We'll need to gather more information for me to safely guide you along this route. Maybe a codex will do the trick! "

>s
You can't go that way.

>w
The harsh environment immediately begins to tax your suit's systems.

Tepetentli
You stand at the base of the cliffs, looking up at their jagged, worn edges. White, artificial arms with their pneumatic veins long since torn, break through the sand as though reaching for the heavens. You weigh whether to proceed up the cliffs to the west or continue down south along the ridges of the cliffs.

>w
The harsh environment immediately begins to tax your suit's systems.

Higher Tepetentli
The climb has brought you to a precarious ledge with a panoramic view of the silica desert. Enormous extraction scars are visible from this vantage point, giving you some perspective as to the scale of the operation of this devastated land. A small shelter has been constructed here, seemingly from scavenged materials.

A tool repurposed as a weapon, with sharp crystalline shards embedded in the handle. It could be effective against threats.

>w
You can't go that way.

>pick up weapon
Taken.

>e
The harsh environment immediately begins to tax your suit's systems.

Tepetentli
You stand at the base of the cliffs, looking up at their jagged, worn edges. White, artificial arms with their pneumatic veins long since torn, break through the sand as though reaching for the heavens. You weigh whether to proceed up the cliffs to the west or continue down south along the ridges of the cliffs.

* * *

>s
You can't go that way.

>use codex on self
You can't see any such thing.

>i
You are carrying:
  a makeshift weapon

* * *

>take codex
Taken.

>use codes on me
You can't see any such thing.

>use codex on self
You insert the Fragmented Worker Codex into your suit's interface port. After a moment, Nezin's voice speaks in your ear:

QZL Corp promised us safety, but the filtration systems fail ever more frequently. The silica gets finer every day as they push production targets higher. Three workers ccrystallized last week when their suits malfunctioned. QZL representatives merely noted the incident and increased our quotas to compensate for the loss.

I have updated your navigation systems. I detect a possible shelter on the higher ridge to the west of Tepetentli. It may contain useful resources.

>s
The harsh environment immediately begins to tax your suit's systems.

Peak of Istaktepetl
Large, coarse grains of sand, mostly a shimmering, unnatural white, brush over the mounds beneath your feet and your boots alike. The sun beats down on your suit and eats away at the exposed back of your neck. You peer out and see a shaded cave outcropping just to the North.

>w
The harsh environment immediately begins to tax your suit's systems.

Tepetentli
You stand at the base of the cliffs, looking up at their jagged, worn edges. White, artificial arms with their pneumatic veins long since torn, break through the sand as though reaching for the heavens. You weigh whether to proceed up the cliffs to the west or continue down south along the ridges of the cliffs.

* * *

>take codex
Taken.

>use codex
You must supply a second noun.

>s
The harsh environment immediately begins to tax your suit's systems.

Peak of Istaktepetl
You have returned to the peak once again to serve as your vantage point. You hope that it will serve as your guidance to unraveling the mystery you've been marooned here to solve. You peer out and see a shaded cave outcropping to the North, cliffs to the West, and what appears to be an ancient road to the East.

* * *

>w
"Sorry user, that path is not accessible yet. We'll need to gather more information for me to safely guide you along this route. Maybe a codex will do the trick! "

>take codex
You already have that.

>use codex on me
You insert the Fragmented Worker Codex into your suit's interface port. After a moment, Nezin's voice speaks in your ear:

QZL Corp promised us safety, but the filtration systems fail ever more frequently. The silica gets finer every day as they push production targets higher. Three workers ccrystallized last week when their suits malfunctioned. QZL representatives merely noted the incident and increased our quotas to compensate for the loss.

I have updated your navigation systems. I detect a possible shelter on the higher ridge to the west of Tepetentli. It may contain useful resources.

>w
The harsh environment immediately begins to tax your suit's systems.

Higher Tepetentli
The climb has brought you to a precarious ledge with a panoramic view of the silica desert. Enormous extraction scars are visible from this vantage point, giving you some perspective as to the scale of the operation of this devastated land. A small shelter has been constructed here, seemingly from scavenged materials.

A tool repurposed as a weapon, with sharp crystalline shards embedded in the handle. It could be effective against threats.

You can also see a Scientific Warning Codex here.

>take all
Scientific Warning Codex: Taken.
makeshift weapon: Taken.

* * *

>e
The harsh environment immediately begins to tax your suit's systems.

Peak of Istaktepetl
You have returned to the peak once again to serve as your vantage point. You hope that it will serve as your guidance to unraveling the mystery you've been marooned here to solve. You peer out and see a shaded cave outcropping to the North, cliffs to the West, and what appears to be an ancient road to the East.

>e
The harsh environment immediately begins to tax your suit's systems.

Nohpalli Road
What was once a well-traveled road now lies mostly reclaimed by silica drifts. The remnants of transport tracks can still be seen and the occasional broken cargo container lies half-buried. To the south you can see what appears to be habitation domes, while the road continues east towards fields of strange vegitation.

>s
"Sorry user, that path is not accessible yet. We'll need to gather more information for me to safely guide you along this route. Maybe a codex will do the trick! "

>i
You are carrying:
  a makeshift weapon
  a Scientific Warning Codex

>use codex on self
You insert the Scientific Warning Codex into your suit's interface port. After a moment, Nezin's voice speaks in your ear:

Our simulations clearly show that continued extraction at current rates will cause catastrophic environmental cascade. The silica particulate concentration has reached critical levels in the atmosphere. We've also observed the first signs of autonomous reorganization in the waste deposits - silicon-based structures forming without input. I've recommended immediate production halt, but QZL Corp leadership has dismissed our findings.

"This data correlates with unusual readings I'm detecting from the abandoned worker habitation to the south of the Nohpalli Road. We should investigate there."

>s
You feel relief as the filtered environment allows your suit to conserve fuel.

Abandoned Habitation
This room is filtered. A cluster of habitation domes now cracked and partially collapsed. It appears to have been worker housing for those tending the Nohpalli fields and harvesting silicon and silica. Personal belongings still litter the area, suggesting a hasty evacuation. A communal terminal stands in the central plaza, remarkably still intact.

A crystalline object shaped like an ancient key, with circuit patterns embedded within.

You can also see an Evacuation Order Codex here.

>take all
Evacuation Order Codex: Taken.
ceremonial key: Taken.

>use codex
You must supply a second noun.

>use codex on me
You insert the Evacuation Order Codex into your suit's interface port. After a moment, Nezin's voice speaks in your ear:

IMMEDIATE EVACUATION ORDERED. All personnel must report to designated transport zones within 24 hours. Take only essential items. QZL Corp has classified all research materials as corporate property - removal is prohibited. The planet has been designated as QUARANTINED until further notice. Do not attempt independent launches.

"The evacuation records indicate that not all workers complied. A significant group barricaded themselves in the Teocalli Processing Center south of the Nohpalli Fields."

>check suit charge
You can't see any such thing.

>check suit fuel
You can't see any such thing.

>x suit
Your suit's fuel is currently at 52%.
Your personal strength is at 
*** Run-time problem P10: Since nothing is not allowed the property "strength", it is against the rules to try to use it.

0.
Your suit is holding, but you shouldn't linger in exposed areas too long.

* * *

>use codex
You must supply a second noun.

>use codex self
I only understood you as far as wanting to use the Fragmented Worker Codex.

>use codex on self
You insert the Fragmented Worker Codex into your suit's interface port. After a moment, Nezin's voice speaks in your ear:

QZL Corp promised us safety, but the filtration systems fail ever more frequently. The silica gets finer every day as they push production targets higher. Three workers ccrystallized last week when their suits malfunctioned. QZL representatives merely noted the incident and increased our quotas to compensate for the loss.

I have updated your navigation systems. I detect a possible shelter on the higher ridge to the west of Tepetentli. It may contain useful resources.

>s
The harsh environment immediately begins to tax your suit's systems.

Peak of Istaktepetl
You have returned to the peak once again to serve as your vantage point. You hope that it will serve as your guidance to unraveling the mystery you've been marooned here to solve. You peer out and see a shaded cave outcropping to the North, cliffs to the West, and what appears to be an ancient road to the East.

* * *

>take all
Scientific Warning Codex: Taken.
makeshift weapon: Taken.

>use codex on me
You insert the Scientific Warning Codex into your suit's interface port. After a moment, Nezin's voice speaks in your ear:

Our simulations clearly show that continued extraction at current rates will cause catastrophic environmental cascade. The silica particulate concentration has reached critical levels in the atmosphere. We've also observed the first signs of autonomous reorganization in the waste deposits - silicon-based structures forming without input. I've recommended immediate production halt, but QZL Corp leadership has dismissed our findings.

This data correlates with unusual readings I'm detecting from the abandoned worker habitation to the south of the Nohpalli Road. We should investigate there.

* * *

>e
The harsh environment immediately begins to tax your suit's systems.

Nohpalli Road
What was once a well-traveled road now lies mostly reclaimed by silica drifts. The remnants of transport tracks can still be seen and the occasional broken cargo container lies half-buried. To the south you can see what appears to be habitation domes, while the road continues east towards fields of strange vegitation.

>s
You feel relief as the filtered environment allows your suit to conserve fuel.

Abandoned Habitation
This room is filtered. A cluster of habitation domes now cracked and partially collapsed. It appears to have been worker housing for those tending the Nohpalli fields and harvesting silicon and silica. Personal belongings still litter the area, suggesting a hasty evacuation. A communal terminal stands in the central plaza, remarkably still intact.

A crystalline object shaped like an ancient key, with circuit patterns embedded within.

You can also see an Evacuation Order Codex here.

>take codex
Taken.

>use codex on me
You insert the Evacuation Order Codex into your suit's interface port. After a moment, Nezin's voice speaks in your ear:

IMMEDIATE EVACUATION ORDERED. All personnel must report to designated transport zones within 24 hours. Take only essential items. QZL Corp has classified all research materials as corporate property - removal is prohibited. The planet has been designated as QUARANTINED until further notice. Do not attempt independent launches.

The evacuation records indicate that not all workers complied. A significant group barricaded themselves in the Teocalli Processing Center south of the Nohpalli Fields.

>s
You can't go that way.

>take key
Taken.

>n
The harsh environment immediately begins to tax your suit's systems.

Nohpalli Road
What was once a well-traveled road now lies mostly reclaimed by silica drifts. The remnants of transport tracks can still be seen and the occasional broken cargo container lies half-buried. To the south you can see what appears to be habitation domes, while the road continues east towards fields of strange vegitation.

>e
The harsh environment immediately begins to tax your suit's systems.

Nohpalli Fields
Rows of dried and calcified cacti streth before you. Their flesh was once a deep blue-green, but in the absence of their caretakers and the exposure to the harsh conditions they were asked to absorb far too much silica and ultimately shriveled away.

A container of sacred green gel that repairs environmental suits.

>take salve
Taken.

>use salve on me
You apply the sacred green gel to your left forearm's indented recepticle, reciting the ancient technician's prayer. Fuel increased to 100%.

>s
The harsh environment immediately begins to tax your suit's systems.

Teocalli Processing Center
An imposing, pyramid structure rises before you, its terraced levels housing machinery designed to process both Nohpalli plants and Silicon alike to extract and refine their valuable compunds. The entrance to the facility is just to your south.

You can see a Resistance Manifesto Codex here.

>take codex
Taken.

>use codex on me
You insert the Resistance Manifesto Codex into your suit's interface port. After a moment, Nezin's voice speaks in your ear:

They're abandoning us. Only executive-level personnel are being evacuated. We've barricaded the southern processing center and have established contact with workers from three other regions. We know what we've seen - the silica is becoming something else. The old stories speak of the world punishing those who take without reverence. The Second Sun is ending, but we will survive to see the Third.

Warning: I am detecting massive energy readings from the Inner Sanctum. The entity designated "Coatlcircuit" may have formed there. Proceed with extreme caution.

>n
The harsh environment immediately begins to tax your suit's systems.

Nohpalli Fields
Rows of dried and calcified cacti streth before you. Their flesh was once a deep blue-green, but in the absence of their caretakers and the exposure to the harsh conditions they were asked to absorb far too much silica and ultimately shriveled away.

>e
You can't go that way.

>s
The harsh environment immediately begins to tax your suit's systems.

Teocalli Processing Center
An imposing, pyramid structure rises before you, its terraced levels housing machinery designed to process both Nohpalli plants and Silicon alike to extract and refine their valuable compunds. The entrance to the facility is just to your south.

>s
"Sorry user, that path is not accessible yet. We'll need to gather more information for me to safely guide you along this route. Maybe a codex will do the trick! "

>use codex on self
You can't see any such thing.

>i
You are carrying:
  a ceremonial key
  a makeshift weapon

* * *

>take codex
Taken.

>use codex on me
You insert the Fragmented Worker Codex into your suit's interface port. After a moment, Nezin's voice speaks in your ear:

QZL Corp promised us safety, but the filtration systems fail ever more frequently. The silica gets finer every day as they push production targets higher. Three workers ccrystallized last week when their suits malfunctioned. QZL representatives merely noted the incident and increased our quotas to compensate for the loss.

I have updated your navigation systems. I detect a possible shelter on the higher ridge to the west of Tepetentli. It may contain useful resources."I have stored this codex data in my memory banks. When we reach the ritual platform in the Inner Sanctum, I can project the codex onto the platform to activate it."

>s
The harsh environment immediately begins to tax your suit's systems.

Peak of Istaktepetl
You have returned to the peak once again to serve as your vantage point. You hope that it will serve as your guidance to unraveling the mystery you've been marooned here to solve. You peer out and see a shaded cave outcropping to the North, cliffs to the West, and what appears to be an ancient road to the East.

* * *

>take all
Scientific Warning Codex: Taken.
makeshift weapon: Taken.

>take codex
You already have that.

>e
The harsh environment immediately begins to tax your suit's systems.

Tepetentli
You stand at the base of the cliffs, looking up at their jagged, worn edges. White, artificial arms with their pneumatic veins long since torn, break through the sand as though reaching for the heavens. You weigh whether to proceed up the cliffs to the west or continue down south along the ridges of the cliffs.

* * *

>s
"Sorry user, that path is not accessible yet. We'll need to gather more information for me to safely guide you along this route. Maybe a codex will do the trick! "

>take codex
You already have that.

>i
You are carrying:
  a makeshift weapon
  a Scientific Warning Codex

>use codex on me
You insert the Scientific Warning Codex into your suit's interface port. After a moment, Nezin's voice speaks in your ear:

Our simulations clearly show that continued extraction at current rates will cause catastrophic environmental cascade. The silica particulate concentration has reached critical levels in the atmosphere. We've also observed the first signs of autonomous reorganization in the waste deposits - silicon-based structures forming without input. I've recommended immediate production halt, but QZL Corp leadership has dismissed our findings.

"This data correlates with unusual readings I'm detecting from the abandoned worker habitation to the south of the Nohpalli Road. We should investigate there."

>s
You feel relief as the filtered environment allows your suit to conserve fuel.

Abandoned Habitation
This room is filtered. A cluster of habitation domes now cracked and partially collapsed. It appears to have been worker housing for those tending the Nohpalli fields and harvesting silicon and silica. Personal belongings still litter the area, suggesting a hasty evacuation. A communal terminal stands in the central plaza, remarkably still intact.

A crystalline object shaped like an ancient key, with circuit patterns embedded within.

You can also see an Evacuation Order Codex here.

* * *

>take codex
Taken.

>use codex on me
You insert the Evacuation Order Codex into your suit's interface port. After a moment, Nezin's voice speaks in your ear:

IMMEDIATE EVACUATION ORDERED. All personnel must report to designated transport zones within 24 hours. Take only essential items. QZL Corp has classified all research materials as corporate property - removal is prohibited. The planet has been designated as QUARANTINED until further notice. Do not attempt independent launches.

"The evacuation records indicate that not all workers complied. A significant group barricaded themselves in the Teocalli Processing Center south of the Nohpalli Fields."

>n
The harsh environment immediately begins to tax your suit's systems.

Nohpalli Road
What was once a well-traveled road now lies mostly reclaimed by silica drifts. The remnants of transport tracks can still be seen and the occasional broken cargo container lies half-buried. To the south you can see what appears to be habitation domes, while the road continues east towards fields of strange vegitation.

>e
The harsh environment immediately begins to tax your suit's systems.

Nohpalli Fields
Rows of dried and calcified cacti streth before you. Their flesh was once a deep blue-green, but in the absence of their caretakers and the exposure to the harsh conditions they were asked to absorb far too much silica and ultimately shriveled away.

A container of sacred green gel that can be used as biofuel.

A deep rattle pulses for three beats. Two of your suit's protection glyps glow a deep amber. Cuahtli fuel is at 49%.

>take salve
Taken.

A deep rattle pulses for three beats. Two of your suit's protection glyps glow a deep amber. Cuahtli fuel is at 46%.

>s
The harsh environment immediately begins to tax your suit's systems.

Teocalli Processing Center
An imposing, pyramid structure rises before you, its terraced levels housing machinery designed to process both Nohpalli plants and Silicon alike to extract and refine their valuable compunds. The entrance to the facility is just to your south.

You can see a Resistance Manifesto Codex here.

A deep rattle pulses for three beats. Two of your suit's protection glyps glow a deep amber. Cuahtli fuel is at 43%.

>i
You are carrying:
  a nohpalli salve
  a makeshift weapon

A deep rattle pulses for three beats. Two of your suit's protection glyps glow a deep amber. Cuahtli fuel is at 40%.

>take codex
Taken.

A deep rattle pulses for three beats. Two of your suit's protection glyps glow a deep amber. Cuahtli fuel is at 37%.

>use codex on me
You insert the Resistance Manifesto Codex into your suit's interface port. After a moment, Nezin's voice speaks in your ear:

They're abandoning us. Only executive-level personnel are being evacuated. We've barricaded the southern processing center and have established contact with workers from three other regions. We know what we've seen - the silica is becoming something else. The old stories speak of the world punishing those who take without reverence. The Second Sun is ending, but we will survive to see the Third.

"Warning: I am detecting massive energy readings from the Inner Sanctum. The entity designated "Coatlcircuit" may have formed there. Proceed with extreme caution."
A deep rattle pulses for three beats. Two of your suit's protection glyps glow a deep amber. Cuahtli fuel is at 34%.

>s
You feel relief as the filtered environment allows your suit to conserve fuel.

Processing Center Interior
This room is filtered. The entire facility is arranged in a cyclical fashion with conveyor systems forming concentric circles around a central processing core. Warning signs in multiple languages are posted around the room. In a small alcove to the side, you notice what appears to be a hidden vault, partially open.

You can see a Final Observation Codex and a hidden vault here.

A deep rattle pulses for three beats. Two of your suit's protection glyps glow a deep amber. Cuahtli fuel is at 34%.

>take final observation codex
Taken.

A deep rattle pulses for three beats. Two of your suit's protection glyps glow a deep amber. Cuahtli fuel is at 34%.

>use salve on self
You apply the sacred green gel to your left forearm's indented recepticle, reciting the ancient technician's prayer. Fuel increased to 84%.

>i
You are carrying:
  a Final Observation Codex
  a makeshift weapon

>use codex on me
You insert the Final Observation Codex into your suit's interface port. After a moment, Nezin's voice speaks in your ear:

The silica has achieved consciousness. Our instruments detect organized electrical patterns throughout the largest deposits. The workers called it Coatlcircuit - the Circuit Serpent. It grows stronger as it absorbs more silicon. Those who remained have started worshipping it, offering their suits and even their bodies to "ascend." I believe we've witnessed the birth of a new form of life, one that may eventually reach beyond this planet. This will be my final recording before I join them.

"This appears to be the final piece of the historical record. The Ritual of Ascension mentioned in previous codices might be performed in the Inner Sanctum using the five memory codices."

>n
The harsh environment immediately begins to tax your suit's systems.

Teocalli Processing Center
An imposing, pyramid structure rises before you, its terraced levels housing machinery designed to process both Nohpalli plants and Silicon alike to extract and refine their valuable compunds. The entrance to the facility is just to your south.

>n
The harsh environment immediately begins to tax your suit's systems.

Nohpalli Fields
Rows of dried and calcified cacti streth before you. Their flesh was once a deep blue-green, but in the absence of their caretakers and the exposure to the harsh conditions they were asked to absorb far too much silica and ultimately shriveled away.

>w
The harsh environment immediately begins to tax your suit's systems.

Nohpalli Road
What was once a well-traveled road now lies mostly reclaimed by silica drifts. The remnants of transport tracks can still be seen and the occasional broken cargo container lies half-buried. To the south you can see what appears to be habitation domes, while the road continues east towards fields of strange vegitation.

>w
The harsh environment immediately begins to tax your suit's systems.

Peak of Istaktepetl
You have returned to the peak once again to serve as your vantage point. You hope that it will serve as your guidance to unraveling the mystery you've been marooned here to solve. You peer out and see a shaded cave outcropping to the North, cliffs to the West, and what appears to be an ancient road to the East.

* * *

>n
The harsh environment immediately begins to tax your suit's systems.

Ximopoua Cave
The cave provides a welcome shelter from the harsh sun. Silicon crystals burst from every wall you see like metallic stalactites and catch what little light enters casting an ethereal green glow. Ancient extraction equipment lies decrepit and abandoned with drills, chisels, and, -disturbingly- helmets of Cuahtli suits poking through the surface of the silica dust. A narrow passage leads deeper North into the cave system, while the exit to the south leads back to the peak.

>n
"Sorry user, that path is not accessible yet. We'll need to gather more information for me to safely guide you along this route. Maybe a codex will do the trick! "

>i
You are carrying:
  a makeshift weapon

* * *

>take all
Scientific Warning Codex: Taken.
makeshift weapon: Taken.

>use codex on me
You insert the Scientific Warning Codex into your suit's interface port. After a moment, Nezin's voice speaks in your ear:

Our simulations clearly show that continued extraction at current rates will cause catastrophic environmental cascade. The silica particulate concentration has reached critical levels in the atmosphere. We've also observed the first signs of autonomous reorganization in the waste deposits - silicon-based structures forming without input. I've recommended immediate production halt, but QZL Corp leadership has dismissed our findings.

"This data correlates with unusual readings I'm detecting from the abandoned worker habitation to the south of the Nohpalli Road. We should investigate there."

>e
The harsh environment immediately begins to tax your suit's systems.

Tepetentli
You stand at the base of the cliffs, looking up at their jagged, worn edges. White, artificial arms with their pneumatic veins long since torn, break through the sand as though reaching for the heavens. You weigh whether to proceed up the cliffs to the west or continue down south along the ridges of the cliffs.

>e
The harsh environment immediately begins to tax your suit's systems.

Peak of Istaktepetl
You have returned to the peak once again to serve as your vantage point. You hope that it will serve as your guidance to unraveling the mystery you've been marooned here to solve. You peer out and see a shaded cave outcropping to the North, cliffs to the West, and what appears to be an ancient road to the East.

A deep rattle pulses for three beats. Two of your suit's protection glyps glow a deep amber. Cuahtli fuel is at 50%.

>e
The harsh environment immediately begins to tax your suit's systems.

Nohpalli Road
What was once a well-traveled road now lies mostly reclaimed by silica drifts. The remnants of transport tracks can still be seen and the occasional broken cargo container lies half-buried. To the south you can see what appears to be habitation domes, while the road continues east towards fields of strange vegitation.

A deep rattle pulses for three beats. Two of your suit's protection glyps glow a deep amber. Cuahtli fuel is at 45%.

>s
You feel relief as the filtered environment allows your suit to conserve fuel.

Abandoned Habitation
This room is filtered. A cluster of habitation domes now cracked and partially collapsed. It appears to have been worker housing for those tending the Nohpalli fields and harvesting silicon and silica. Personal belongings still litter the area, suggesting a hasty evacuation. A communal terminal stands in the central plaza, remarkably still intact.

A crystalline object shaped like an ancient key, with circuit patterns embedded within.

You can also see an Evacuation Order Codex here.

A deep rattle pulses for three beats. Two of your suit's protection glyps glow a deep amber. Cuahtli fuel is at 45%.

>take all
Evacuation Order Codex: Taken.
ceremonial key: Taken.

A deep rattle pulses for three beats. Two of your suit's protection glyps glow a deep amber. Cuahtli fuel is at 45%.

>use codex on me
You insert the Evacuation Order Codex into your suit's interface port. After a moment, Nezin's voice speaks in your ear:

IMMEDIATE EVACUATION ORDERED. All personnel must report to designated transport zones within 24 hours. Take only essential items. QZL Corp has classified all research materials as corporate property - removal is prohibited. The planet has been designated as QUARANTINED until further notice. Do not attempt independent launches.

"The evacuation records indicate that not all workers complied. A significant group barricaded themselves in the Teocalli Processing Center south of the Nohpalli Fields."
A deep rattle pulses for three beats. Two of your suit's protection glyps glow a deep amber. Cuahtli fuel is at 45%.

>n
The harsh environment immediately begins to tax your suit's systems.

Nohpalli Road
What was once a well-traveled road now lies mostly reclaimed by silica drifts. The remnants of transport tracks can still be seen and the occasional broken cargo container lies half-buried. To the south you can see what appears to be habitation domes, while the road continues east towards fields of strange vegitation.

A deep rattle pulses for three beats. Two of your suit's protection glyps glow a deep amber. Cuahtli fuel is at 40%.

>e
The harsh environment immediately begins to tax your suit's systems.

Nohpalli Fields
Rows of dried and calcified cacti streth before you. Their flesh was once a deep blue-green, but in the absence of their caretakers and the exposure to the harsh conditions they were asked to absorb far too much silica and ultimately shriveled away.

A container of sacred green gel that repairs environmental suits.

A deep rattle pulses for three beats. Two of your suit's protection glyps glow a deep amber. Cuahtli fuel is at 35%.

>take salve
Taken.

A deep rattle pulses for three beats. Two of your suit's protection glyps glow a deep amber. Cuahtli fuel is at 30%.

>use salve
You must supply a second noun.

A deep rattle pulses for three beats. Two of your suit's protection glyps glow a deep amber. Cuahtli fuel is at 25%.

>use salve on self
You apply the sacred green gel to your left forearm's indented recepticle, reciting the ancient technician's prayer. Fuel increased to 75%.

>s
The harsh environment immediately begins to tax your suit's systems.

Teocalli Processing Center
An imposing, pyramid structure rises before you, its terraced levels housing machinery designed to process both Nohpalli plants and Silicon alike to extract and refine their valuable compunds. The entrance to the facility is just to your south.

You can see a Resistance Manifesto Codex here.

* * *

>take codex
Taken.

>use codex on self
You insert the Resistance Manifesto Codex into your suit's interface port. After a moment, Nezin's voice speaks in your ear:

They're abandoning us. Only executive-level personnel are being evacuated. We've barricaded the southern processing center and have established contact with workers from three other regions. We know what we've seen - the silica is becoming something else. The old stories speak of the world punishing those who take without reverence. The Second Sun is ending, but we will survive to see the Third.

"Warning: I am detecting massive energy readings from the Inner Sanctum. The entity designated "Coatlcircuit" may have formed there. Proceed with extreme caution."

>s
"Sorry user, that path is not accessible yet. We'll need to gather more information for me to safely guide you along this route. Maybe a codex will do the trick! "
A deep rattle pulses for three beats. Two of your suit's protection glyps glow a deep amber. Cuahtli fuel is at 50%.

* * *

>w
The harsh environment immediately begins to tax your suit's systems.

Higher Tepetentli
The climb has brought you to a precarious ledge with a panoramic view of the silica desert. Enormous extraction scars are visible from this vantage point, giving you some perspective as to the scale of the operation of this devastated land. A small shelter has been constructed here, seemingly from scavenged materials.

A tool repurposed as a weapon, with sharp crystalline shards embedded in the handle. It could be effective against threats.

You can also see a Scientific Warning Codex here.

>take codex
(the Scientific Warning Codex)
Taken.

>use codex on me
Which do you mean, the Scientific Warning Codex or the Fragmented Worker Codex?

>e
I only understood you as far as wanting to use east.

>e
The harsh environment immediately begins to tax your suit's systems.

Tepetentli
You stand at the base of the cliffs, looking up at their jagged, worn edges. White, artificial arms with their pneumatic veins long since torn, break through the sand as though reaching for the heavens. You weigh whether to proceed up the cliffs to the west or continue down south along the ridges of the cliffs.

* * *

>e
The harsh environment immediately begins to tax your suit's systems.

Peak of Istaktepetl
You have returned to the peak once again to serve as your vantage point. You hope that it will serve as your guidance to unraveling the mystery you've been marooned here to solve. You peer out and see a shaded cave outcropping to the North, cliffs to the West, and what appears to be an ancient road to the East.

>s
You can't go that way.

>e
The harsh environment immediately begins to tax your suit's systems.

Nohpalli Road
What was once a well-traveled road now lies mostly reclaimed by silica drifts. The remnants of transport tracks can still be seen and the occasional broken cargo container lies half-buried. To the south you can see what appears to be habitation domes, while the road continues east towards fields of strange vegitation.

* * *

>s
"Sorry user, that path is not accessible yet. We'll need to gather more information for me to safely guide you along this route. Maybe a codex will do the trick! "

>i
You are carrying:
  a Scientific Warning Codex
  a Fragmented Worker Codex

>use codex on self
Which do you mean, the Scientific Warning Codex or the Fragmented Worker Codex?

>scientific warning codex
You insert the Scientific Warning Codex into your suit's interface port. After a moment, Nezin's voice speaks in your ear:

Our simulations clearly show that continued extraction at current rates will cause catastrophic environmental cascade. The silica particulate concentration has reached critical levels in the atmosphere. We've also observed the first signs of autonomous reorganization in the waste deposits - silicon-based structures forming without input. I've recommended immediate production halt, but QZL Corp leadership has dismissed our findings.

"This data correlates with unusual readings I'm detecting from the abandoned worker habitation to the south of the Nohpalli Road. We should investigate there.""I have stored this codex data in my memory banks. When we reach the ritual platform in the Inner Sanctum, I can project the codex onto the platform to activate it."

>use fragmented worker codex on self
You insert the Fragmented Worker Codex into your suit's interface port. After a moment, Nezin's voice speaks in your ear:

QZL Corp promised us safety, but the filtration systems fail ever more frequently. The silica gets finer every day as they push production targets higher. Three workers ccrystallized last week when their suits malfunctioned. QZL representatives merely noted the incident and increased our quotas to compensate for the loss.

I have updated your navigation systems. I detect a possible shelter on the higher ridge to the west of Tepetentli. It may contain useful resources."I have stored this codex data in my memory banks. When we reach the ritual platform in the Inner Sanctum, I can project the codex onto the platform to activate it."

>s
You feel relief as the filtered environment allows your suit to conserve fuel.

Abandoned Habitation
This room is filtered. A cluster of habitation domes now cracked and partially collapsed. It appears to have been worker housing for those tending the Nohpalli fields and harvesting silicon and silica. Personal belongings still litter the area, suggesting a hasty evacuation. A communal terminal stands in the central plaza, remarkably still intact.

A crystalline object shaped like an ancient key, with circuit patterns embedded within.

You can also see an Evacuation Order Codex here.

* * *

>take all
Evacuation Order Codex: Taken.
ceremonial key: Taken.

>use codex on me
Which do you mean, the Evacuation Order Codex, the Scientific Warning Codex or the Fragmented Worker Codex?

>evac
You can't see any such thing.

>evacuation order codex
That's not a verb I recognise.

>use evacuation order codex on me
You insert the Evacuation Order Codex into your suit's interface port. After a moment, Nezin's voice speaks in your ear:

IMMEDIATE EVACUATION ORDERED. All personnel must report to designated transport zones within 24 hours. Take only essential items. QZL Corp has classified all research materials as corporate property - removal is prohibited. The planet has been designated as QUARANTINED until further notice. Do not attempt independent launches.

"The evacuation records indicate that not all workers complied. A significant group barricaded themselves in the Teocalli Processing Center south of the Nohpalli Fields.""I have stored this codex data in my memory banks. When we reach the ritual platform in the Inner Sanctum, I can project the codex onto the platform to activate it."

>n
The harsh environment immediately begins to tax your suit's systems.

Nohpalli Road
What was once a well-traveled road now lies mostly reclaimed by silica drifts. The remnants of transport tracks can still be seen and the occasional broken cargo container lies half-buried. To the south you can see what appears to be habitation domes, while the road continues east towards fields of strange vegitation.

* * *

>use codex on me
Which do you mean, the Scientific Warning Codex or the Fragmented Worker Codex?

>take weapon
Taken.

>l
Higher Tepetentli
The climb has brought you to a precarious ledge with a panoramic view of the silica desert. Enormous extraction scars are visible from this vantage point, giving you some perspective as to the scale of the operation of this devastated land. A small shelter has been constructed here, seemingly from scavenged materials.

>x surroundings
You can't see any such thing.

>x
(the makeshift weapon)
Originally a silicon extraction tool, this has been modified with sharp crystal fragments to serve as a weapon. The handle still bears the corporation logo, now mostly scratched out.

>e
The harsh environment immediately begins to tax your suit's systems.

Tepetentli
You stand at the base of the cliffs, looking up at their jagged, worn edges. White, artificial arms with their pneumatic veins long since torn, break through the sand as though reaching for the heavens. You weigh whether to proceed up the cliffs to the west or continue down south along the ridges of the cliffs.

* * *

>take all
Evacuation Order Codex: Taken.
ceremonial key: Taken.

>n
The harsh environment immediately begins to tax your suit's systems.

Nohpalli Road
What was once a well-traveled road now lies mostly reclaimed by silica drifts. The remnants of transport tracks can still be seen and the occasional broken cargo container lies half-buried. To the south you can see what appears to be habitation domes, while the road continues east towards fields of strange vegitation.

>e
The harsh environment immediately begins to tax your suit's systems.

Nohpalli Fields
Rows of dried and calcified cacti streth before you. Their flesh was once a deep blue-green, but in the absence of their caretakers and the exposure to the harsh conditions they were asked to absorb far too much silica and ultimately shriveled away.

A container of sacred green gel that can be used as biofuel.

>take salve
Taken.

A deep rattle pulses for three beats. Two of your suit's protection glyps glow a deep amber. Cuahtli fuel is at 49%.

>s
"Sorry user, that path is not accessible yet. We'll need to gather more information for me to safely guide you along this route. Maybe a codex will do the trick! "
A deep rattle pulses for three beats. Two of your suit's protection glyps glow a deep amber. Cuahtli fuel is at 46%.

>i
You are carrying:
  a nohpalli salve
  a ceremonial key
  an Evacuation Order Codex
  a makeshift weapon

A deep rattle pulses for three beats. Two of your suit's protection glyps glow a deep amber. Cuahtli fuel is at 43%.

>use codex on self
You insert the Evacuation Order Codex into your suit's interface port. After a moment, Nezin's voice speaks in your ear:

IMMEDIATE EVACUATION ORDERED. All personnel must report to designated transport zones within 24 hours. Take only essential items. QZL Corp has classified all research materials as corporate property - removal is prohibited. The planet has been designated as QUARANTINED until further notice. Do not attempt independent launches.

"The evacuation records indicate that not all workers complied. A significant group barricaded themselves in the Teocalli Processing Center south of the Nohpalli Fields."
A deep rattle pulses for three beats. Two of your suit's protection glyps glow a deep amber. Cuahtli fuel is at 40%.

>s
The harsh environment immediately begins to tax your suit's systems.

Teocalli Processing Center
An imposing, pyramid structure rises before you, its terraced levels housing machinery designed to process both Nohpalli plants and Silicon alike to extract and refine their valuable compunds. The entrance to the facility is just to your south.

You can see a Resistance Manifesto Codex here.

A deep rattle pulses for three beats. Two of your suit's protection glyps glow a deep amber. Cuahtli fuel is at 37%.

>take codex
Taken.

A deep rattle pulses for three beats. Two of your suit's protection glyps glow a deep amber. Cuahtli fuel is at 34%.

>use salve on self
You apply the sacred green gel to your left forearm's indented recepticle, reciting the ancient technician's prayer. Fuel increased to 84%.

>use codex on me
You insert the Resistance Manifesto Codex into your suit's interface port. After a moment, Nezin's voice speaks in your ear:

They're abandoning us. Only executive-level personnel are being evacuated. We've barricaded the southern processing center and have established contact with workers from three other regions. We know what we've seen - the silica is becoming something else. The old stories speak of the world punishing those who take without reverence. The Second Sun is ending, but we will survive to see the Third.

"Warning: I am detecting massive energy readings from the Inner Sanctum. The entity designated "Coatlcircuit" may have formed there. Proceed with extreme caution."

>s
You feel relief as the filtered environment allows your suit to conserve fuel.

Processing Center Interior
This room is filtered. The entire facility is arranged in a cyclical fashion with conveyor systems forming concentric circles around a central processing core. Warning signs in multiple languages are posted around the room. In a small alcove to the side, you notice what appears to be a hidden vault, partially open.

You can see a Final Observation Codex and a hidden vault here.

>take final codex
Taken.

>use codex on me
You insert the Final Observation Codex into your suit's interface port. After a moment, Nezin's voice speaks in your ear:

The silica has achieved consciousness. Our instruments detect organized electrical patterns throughout the largest deposits. The workers called it Coatlcircuit - the Circuit Serpent. It grows stronger as it absorbs more silicon. Those who remained have started worshipping it, offering their suits and even their bodies to "ascend." I believe we've witnessed the birth of a new form of life, one that may eventually reach beyond this planet. This will be my final recording before I join them.

"This appears to be the final piece of the historical record. The Ritual of Ascension mentioned in previous codices might be performed in the Inner Sanctum using the five memory codices."

* * *

>n
The harsh environment immediately begins to tax your suit's systems.

Ximopoua Cave
The cave provides a welcome shelter from the harsh sun. Silicon crystals burst from every wall you see like metallic stalactites and catch what little light enters casting an ethereal green glow. Ancient extraction equipment lies decrepit and abandoned with drills, chisels, and, -disturbingly- helmets of Cuahtli suits poking through the surface of the silica dust. A narrow passage leads deeper North into the cave system, while the exit to the south leads back to the peak.

>n
You feel relief as the filtered environment allows your suit to conserve fuel.

Inner Sanctum
This room is filtered. This chamber appears to have been a control room of sorts. Terminal interfaces litter the walls, mostly cracked and non-functional. In the center stands a circular platform with five indentations in a triangular stair step pattern. A faded tapestry hanging from the roof above the platform depicts workers in Cuahtli suits harvesting crystalline formations while robed figures observe from a pyramid overlooking them.

A massive, serpentine form composed of crystalline silicon undulates across the chamber. Electrical discharges crackle along its length as it seems to sense your presence.

A circular platform stands in the center of the room, with five indentations arranged in a quincunx pattern.

>put codex on platform
You can't see any such thing.

>put fragmented worker codex on ritual platform
You can't see any such thing.

>put fragmented worker codex on ritual platform
You can't see any such thing.

* * *

>take codex
Taken.

>use codex on self
You insert the Fragmented Worker Codex into your suit's interface port. After a moment, Nezin's voice speaks in your ear:

QZL Corp promised us safety, but the filtration systems fail ever more frequently. The silica gets finer every day as they push production targets higher. Three workers ccrystallized last week when their suits malfunctioned. QZL representatives merely noted the incident and increased our quotas to compensate for the loss.

I have updated your navigation systems. I detect a possible shelter on the higher ridge to the west of Tepetentli. It may contain useful resources."I have stored this codex data in my memory banks. When we reach the ritual platform in the Inner Sanctum, I can project the codex onto the platform to activate it."

* * *

>take all
Scientific Warning Codex: Taken.
makeshift weapon: Taken.

>e
The harsh environment immediately begins to tax your suit's systems.

Tepetentli
You stand at the base of the cliffs, looking up at their jagged, worn edges. White, artificial arms with their pneumatic veins long since torn, break through the sand as though reaching for the heavens. You weigh whether to proceed up the cliffs to the west or return back the way you came to your east.

* * *

>e
The harsh environment immediately begins to tax your suit's systems.

Nohpalli Road
What was once a well-traveled road now lies mostly reclaimed by silica drifts. The remnants of transport tracks can still be seen and the occasional broken cargo container lies half-buried. To the south you can see what appears to be habitation domes, while the road continues east towards fields of strange vegitation. You also see Istaktepetl to your west along the path you came, and what appears to be habitation domes to your south.

>s
"Sorry user, that path is not accessible yet. We'll need to gather more information for me to safely guide you along this route. Maybe a codex will do the trick! "

>use codex on self
Which do you mean, the Scientific Warning Codex or the Fragmented Worker Codex?

>s
You feel relief as the filtered environment allows your suit to conserve fuel.

Abandoned Habitation
This room is filtered. A cluster of habitation domes now cracked and partially collapsed. It appears to have been worker housing for those tending the Nohpalli fields and harvesting silicon and silica. Personal belongings still litter the area, suggesting a hasty evacuation. A communal terminal stands in the central plaza, remarkably still intact.

A crystalline object shaped like an ancient key, with circuit patterns embedded within.

You can also see an Evacuation Order Codex here.

* * *

>e
The harsh environment immediately begins to tax your suit's systems.

Nohpalli Fields
Rows of dried and calcified cacti streth before you. Their flesh was once a deep blue-green, but in the absence of their caretakers and the exposure to the harsh conditions they were asked to absorb far too much silica and ultimately shriveled away.

A container of sacred green gel that can be used as biofuel.

>take salve
Taken.

>s
The harsh environment immediately begins to tax your suit's systems.

Teocalli Processing Center
An imposing, pyramid structure rises before you, its terraced levels housing machinery designed to process both Nohpalli plants and Silicon alike to extract and refine their valuable compunds. The entrance to the facility is just to your south.

You can see a Resistance Manifesto Codex here.

>take codex
(the Resistance Manifesto Codex)
Taken.

A deep rattle pulses for three beats. Two of your suit's protection glyps glow a deep amber. Cuahtli fuel is at 49%.

>use codex on me
Which do you mean, the Resistance Manifesto Codex or the Evacuation Order Codex?

>use evacuation order codex on me
You insert the Evacuation Order Codex into your suit's interface port. After a moment, Nezin's voice speaks in your ear:

IMMEDIATE EVACUATION ORDERED. All personnel must report to designated transport zones within 24 hours. Take only essential items. QZL Corp has classified all research materials as corporate property - removal is prohibited. The planet has been designated as QUARANTINED until further notice. Do not attempt independent launches.

"The evacuation records indicate that not all workers complied. A significant group barricaded themselves in the Teocalli Processing Center south of the Nohpalli Fields."
A deep rattle pulses for three beats. Two of your suit's protection glyps glow a deep amber. Cuahtli fuel is at 46%.

* * *

>use codex on self
Which do you mean, the Scientific Warning Codex or the Fragmented Worker Codex?

>use scientific warning codex on self
You insert the Scientific Warning Codex into your suit's interface port. After a moment, Nezin's voice speaks in your ear:

Our simulations clearly show that continued extraction at current rates will cause catastrophic environmental cascade. The silica particulate concentration has reached critical levels in the atmosphere. We've also observed the first signs of autonomous reorganization in the waste deposits - silicon-based structures forming without input. I've recommended immediate production halt, but QZL Corp leadership has dismissed our findings.

"This data correlates with unusual readings I'm detecting from the abandoned worker habitation to the south of the Nohpalli Road. We should investigate there.""I have stored this codex data in my memory banks. When we reach the ritual platform in the Inner Sanctum, I can project the codex onto the platform to activate it."

>e
The harsh environment immediately begins to tax your suit's systems.

Nohpalli Fields
Rows of dried and calcified cacti streth before you. Their flesh was once a deep blue-green, but in the absence of their caretakers and the exposure to the harsh conditions they were asked to absorb far too much silica and ultimately shriveled away. You can see a Nohpalli Salve resting atop the silica sand. You also peer through the hot shimmering haze and see the nohpalli road to your west, back the way you came, and what looks like a pyramid to your south.

A container of sacred green gel that can be used as biofuel.

>e
You can't go that way.

>e
You can't go that way.

* * *

>check suit
Your suit's fuel is currently at 76%.
Your personal strength is at 10.
Your protection levels are harmonious for now.

>e
The harsh environment immediately begins to tax your suit's systems.

Tepetentli
You stand at the base of the cliffs, looking up at their jagged, worn edges. White, artificial arms with their pneumatic veins long since torn, break through the sand as though reaching for the heavens. You weigh whether to proceed up the cliffs to the west or continue down south along the ridges of the cliffs.

* * *

>take all
Evacuation Order Codex: Taken.
ceremonial key: Taken.

>use codex on me
You insert the Evacuation Order Codex into your suit's interface port. After a moment, Nezin's voice speaks in your ear:

IMMEDIATE EVACUATION ORDERED. All personnel must report to designated transport zones within 24 hours. Take only essential items. QZL Corp has classified all research materials as corporate property - removal is prohibited. The planet has been designated as QUARANTINED until further notice. Do not attempt independent launches.

"The evacuation records indicate that not all workers complied. A significant group barricaded themselves in the Teocalli Processing Center south of the Nohpalli Fields."

* * *

>take salve
Taken.

>suit status
That's not a verb I recognise.

>check suit
Your suit's fuel is currently at 55%.
Your personal strength is at 10.
Your suit is holding, but you shouldn't linger in exposed areas too long.

>s
The harsh environment immediately begins to tax your suit's systems.

Teocalli Processing Center
An imposing, pyramid structure rises before you, its terraced levels housing machinery designed to process both Nohpalli plants and Silicon alike to extract and refine their valuable compunds. The entrance to the facility is just to your south.

You can see a Resistance Manifesto Codex here.

A deep rattle pulses for three beats. Two of your suit's protection glyps glow a deep amber. Cuahtli fuel is at 49%.

>use salve on me
You apply the sacred green gel to your left forearm's indented recepticle, reciting the ancient technician's prayer. Fuel increased to 99%.

>s
You feel relief as the filtered environment allows your suit to conserve fuel.

Teocalli Processing Center interior
This room is filtered. The entire facility is arranged in a cyclical fashion with conveyor systems forming concentric circles around a central processing core. Warning signs in multiple languages are posted around the room. In a small alcove to the side, you notice what appears to be a hidden vault, partially open.

You can see a Final Observation Codex and a hidden vault here.

>take all
Final Observation Codex: Taken.
hidden vault: Taken.

>use codex on me
You insert the Final Observation Codex into your suit's interface port. After a moment, Nezin's voice speaks in your ear:

The silica has achieved consciousness. Our instruments detect organized electrical patterns throughout the largest deposits. The workers called it Coatlcircuit - the Circuit Serpent. It grows stronger as it absorbs more silicon. Those who remained have started worshipping it, offering their suits and even their bodies to "ascend." I believe we've witnessed the birth of a new form of life, one that may eventually reach beyond this planet. This will be my final recording before I join them.

"This appears to be the final piece of the historical record. The Ritual of Ascension mentioned in previous codices might be performed in the Inner Sanctum using the five memory codices."

>n
The harsh environment immediately begins to tax your suit's systems.

Teocalli Processing Center
An imposing, pyramid structure rises before you, its terraced levels housing machinery designed to process both Nohpalli plants and Silicon alike to extract and refine their valuable compunds. The entrance to the facility is just to your south.

You can see a Resistance Manifesto Codex here.

>take
(the Resistance Manifesto Codex)
Taken.

>use codex
You must supply a second noun.

>use codex on self
You insert the Resistance Manifesto Codex into your suit's interface port. After a moment, Nezin's voice speaks in your ear:

They're abandoning us. Only executive-level personnel are being evacuated. We've barricaded the southern processing center and have established contact with workers from three other regions. We know what we've seen - the silica is becoming something else. The old stories speak of the world punishing those who take without reverence. The Second Sun is ending, but we will survive to see the Third.

"Warning: I am detecting massive energy readings from the Inner Sanctum. The entity designated "Coatlcircuit" may have formed there. Proceed with extreme caution."

>n
The harsh environment immediately begins to tax your suit's systems.

Nohpalli Fields
Rows of dried and calcified cacti streth before you. Their flesh was once a deep blue-green, but in the absence of their caretakers and the exposure to the harsh conditions they were asked to absorb far too much silica and ultimately shriveled away.

* * *

>n
"Sorry user, that path is not accessible yet. We'll need to gather more information for me to safely guide you along this route. Maybe a codex will do the trick! "

>i
You are carrying:
  a hidden vault
  a ceremonial key
  a makeshift weapon

>drop vault
Dropped.

* * *

>l
Ximopoua Cave
The cave provides a welcome shelter from the harsh sun. Silicon crystals burst from every wall you see like metallic stalactites and catch what little light enters casting an ethereal green glow. Ancient extraction equipment lies decrepit and abandoned with drills, chisels, and, -disturbingly- helmets of Cuahtli suits poking through the surface of the silica dust. A narrow passage leads deeper North into the cave system, while the exit to the south leads back to the peak.

You can see a hidden vault here.

* * *

>x vault
A small vault partially concealed in the wall. Its door has been damaged, revealing the hidden contents inside - what appears to be the final codex that the resistance members were protecting.

>grab codex
That's not a verb I recognise.

>pick up codex
You can't see any such thing.

>open vault
It isn't something you can open.

A deep rattle pulses for three beats. Two of your suit's protection glyps glow a deep amber. Cuahtli fuel is at 48%.

>break vault
Violence isn't the answer to this one.

A deep rattle pulses for three beats. Two of your suit's protection glyps glow a deep amber. Cuahtli fuel is at 45%.

>open vault door
I only understood you as far as wanting to open the hidden vault.

>open vault
It isn't something you can open.

A deep rattle pulses for three beats. Two of your suit's protection glyps glow a deep amber. Cuahtli fuel is at 42%.

>exit
But you aren't in anything at the moment.

A deep rattle pulses for three beats. Two of your suit's protection glyps glow a deep amber. Cuahtli fuel is at 39%.

>jf
That's not a verb I recognise.

>f
That's not a verb I recognise.

>f
That's not a verb I recognise.

>open vault
It isn't something you can open.

A deep rattle pulses for three beats. Two of your suit's protection glyps glow a deep amber. Cuahtli fuel is at 36%.

>s
The harsh environment immediately begins to tax your suit's systems.

Peak of Istaktepetl
You have returned to the peak once again to serve as your vantage point. You hope that it will serve as your guidance to unraveling the mystery you've been marooned here to solve. You peer out and see a shaded cave outcropping to the North, cliffs to the West, and what appears to be an ancient road to the East.

A deep rattle pulses for three beats. Two of your suit's protection glyps glow a deep amber. Cuahtli fuel is at 33%.

>s
You can't go that way.

A deep rattle pulses for three beats. Two of your suit's protection glyps glow a deep amber. Cuahtli fuel is at 30%.

>s
You can't go that way.

A deep rattle pulses for three beats. Two of your suit's protection glyps glow a deep amber. Cuahtli fuel is at 27%.

>s
You can't go that way.

A deep rattle pulses for three beats. Two of your suit's protection glyps glow a deep amber. Cuahtli fuel is at 24%.

>s
You can't go that way.

A deep rattle pulses for three beats. Two of your suit's protection glyps glow a deep amber. Cuahtli fuel is at 21%.

>s
You can't go that way.

A deep rattle pulses for three beats. Two of your suit's protection glyps glow a deep amber. Cuahtli fuel is at 18%.

>s
You can't go that way.

A shrill whistle rings in your ears for three beats. The last of your suit's glyps glows a foreboding crimson. Cuahtli fuel is critically low at 15%.

>ss
That's not a verb I recognise.

>s
You can't go that way.

A shrill whistle rings in your ears for three beats. The last of your suit's glyps glows a foreboding crimson. Cuahtli fuel is critically low at 12%.

>s
You can't go that way.

A shrill whistle rings in your ears for three beats. The last of your suit's glyps glows a foreboding crimson. Cuahtli fuel is critically low at 9%.

>s
You can't go that way.

A shrill whistle rings in your ears for three beats. The last of your suit's glyps glows a foreboding crimson. Cuahtli fuel is critically low at 6%.

>s
You can't go that way.

A shrill whistle rings in your ears for three beats. The last of your suit's glyps glows a foreboding crimson. Cuahtli fuel is critically low at 3%.

>s
You can't go that way.

A shrill whistle rings in your ears for three beats. The last of your suit's glyps glows a foreboding crimson. Cuahtli fuel is critically low at 0%.

    *** Your suit has run out of fuel. Nezin can no longer respond nor help you. You close your eyes and take a deep, unfiltered breath of the planet's air for the first time. You feel the silica start to crystalize your lungs, as you pray that you have done enough to ascend realms rather than descend. ***

Would you like to RESTART, RESTORE a saved game, QUIT or UNDO the last command?

* * *

>take fragmented worker codex
Taken.

>use codex on me
You insert the Fragmented Worker Codex into your suit's interface port. After a moment, Nezin's voice speaks in your ear:

QZL Corp promised us safety, but the filtration systems fail ever more frequently. The silica gets finer every day as they push production targets higher. Three workers ccrystallized last week when their suits malfunctioned. QZL representatives merely noted the incident and increased our quotas to compensate for the loss.

I have updated your navigation systems. I detect a possible shelter on the higher ridge to the west of Tepetentli. It may contain useful resources."I have stored this codex data in my memory banks. When we reach the ritual platform in the Inner Sanctum, I can project the codex onto the platform to activate it."

* * *

>take codex
(the Scientific Warning Codex)
Taken.

>use scientific warning codex
You must supply a second noun.

>use scientific warning codex on me
You insert the Scientific Warning Codex into your suit's interface port. After a moment, Nezin's voice speaks in your ear:

Our simulations clearly show that continued extraction at current rates will cause catastrophic environmental cascade. The silica particulate concentration has reached critical levels in the atmosphere. We've also observed the first signs of autonomous reorganization in the waste deposits - silicon-based structures forming without input. I've recommended immediate production halt, but QZL Corp leadership has dismissed our findings.

"This data correlates with unusual readings I'm detecting from the abandoned worker habitation to the south of the Nohpalli Road. We should investigate there.""I have stored this codex data in my memory banks. When we reach the ritual platform in the Inner Sanctum, I can project the codex onto the platform to activate it."

>e
The harsh environment immediately begins to tax your suit's systems.

Tepetentli
You stand at the base of the cliffs, looking up at their jagged, worn edges. White, artificial arms with their pneumatic veins long since torn, break through the sand as though reaching for the heavens. You weigh whether to proceed up the cliffs to the west or return back the way you came to your east.

* * *

>take all
Evacuation Order Codex: Taken.
ceremonial key: Taken.

>use evacuation order codex on self
You insert the Evacuation Order Codex into your suit's interface port. After a moment, Nezin's voice speaks in your ear:

IMMEDIATE EVACUATION ORDERED. All personnel must report to designated transport zones within 24 hours. Take only essential items. QZL Corp has classified all research materials as corporate property - removal is prohibited. The planet has been designated as QUARANTINED until further notice. Do not attempt independent launches.

"The evacuation records indicate that not all workers complied. A significant group barricaded themselves in the Teocalli Processing Center south of the Nohpalli Fields.""I have stored this codex data in my memory banks. When we reach the ritual platform in the Inner Sanctum, I can project the codex onto the platform to activate it."

>n
The harsh environment immediately begins to tax your suit's systems.

Nohpalli Road
What was once a well-traveled road now lies mostly reclaimed by silica drifts. The remnants of transport tracks can still be seen and the occasional broken cargo container lies half-buried. To the south you can see what appears to be habitation domes, while the road continues east towards fields of strange vegitation. You also see Istaktepetl to your west along the path you came, and what appears to be habitation domes to your south.

* * *

>take all
Nohpalli Salve: Taken.

>s
The harsh environment immediately begins to tax your suit's systems.

Teocalli Processing Center
An imposing, pyramid structure rises before you, its terraced levels housing machinery designed to process both Nohpalli plants and Silicon alike to extract and refine their valuable compunds. The entrance to the facility is just to your south. Meanwhile you glance around and see the Nohpalli fields to the north, back the way you came.

You can see a Resistance Manifesto Codex here.

>take codex
(the Resistance Manifesto Codex)
Taken.

A deep rattle pulses for three beats. Two of your suit's protection glyps glow a deep amber. Cuahtli fuel is at 49%.

>use resistance manifesto codex on self
You insert the Resistance Manifesto Codex into your suit's interface port. After a moment, Nezin's voice speaks in your ear:

They're abandoning us. Only executive-level personnel are being evacuated. We've barricaded the southern processing center and have established contact with workers from three other regions. We know what we've seen - the silica is becoming something else. The old stories speak of the world punishing those who take without reverence. The Second Sun is ending, but we will survive to see the Third.

"Warning: I am detecting massive energy readings from the Inner Sanctum. The entity designated "Coatlcircuit" may have formed there. Proceed with extreme caution.""I have stored this codex data in my memory banks. When we reach the ritual platform in the Inner Sanctum, I can project the codex onto the platform to activate it."
A deep rattle pulses for three beats. Two of your suit's protection glyps glow a deep amber. Cuahtli fuel is at 46%.

>take nohpalli salve
You already have that.

A deep rattle pulses for three beats. Two of your suit's protection glyps glow a deep amber. Cuahtli fuel is at 43%.

>use salve on self
You apply the sacred green gel to your left forearm's indented recepticle, reciting the ancient technician's prayer. Fuel increased to 93%.

>s
You feel relief as the filtered environment allows your suit to conserve fuel.

Processing Center Interior
This room is filtered. The entire facility is arranged in a cyclical fashion with conveyor systems forming concentric circles around a central processing core. Warning signs in multiple languages are posted around the room. The exit is back the way you came, just to your north.

You can see a Final Observation Codex here.

>take all
Final Observation Codex: Taken.

>use final observation codex on self
You insert the Final Observation Codex into your suit's interface port. After a moment, Nezin's voice speaks in your ear:

The silica has achieved consciousness. Our instruments detect organized electrical patterns throughout the largest deposits. The workers called it Coatlcircuit - the Circuit Serpent. It grows stronger as it absorbs more silicon. Those who remained have started worshipping it, offering their suits and even their bodies to "ascend." I believe we've witnessed the birth of a new form of life, one that may eventually reach beyond this planet. This will be my final recording before I join them.

"This appears to be the final piece of the historical record. The Ritual of Ascension mentioned in previous codices might be performed in the Inner Sanctum using the five memory codices.""I have stored this codex data in my memory banks. When we reach the ritual platform in the Inner Sanctum, I can project the codex onto the platform to activate it."

* * *

>activate platform
"I can project the following codices onto the platform: 5 out of 5 required for the ritual."

Do you want me to project all collected codices? (YES/NO)

>yes
As Nezin projects the final codex onto the platform, the entire structure begins to hum with energy. The five points illuminate in sequence, then simultaneously project beams of light that converge above the platform.

A holographic display forms, showing the complete history of this world - from the first silicon miners to the creation of the Coatlcircuit and beyond. You realize this is what the remaining workers were trying to preserve - the truth of what happened here, both as warning and as guide.

As the display concludes, the platform reconfigures, revealing a small crystalline object at its center - a complete archive of the planet's history and technology, designed to be transported offworld.

With this knowledge in your possession, you now face a choice:

Will you warn other worlds about the dangers of unchecked resource extraction?

Or will you reveal secrets of silicon consciousness that might revolutionize technology?

>warn other worlds
You decide to use the knowledge as a warning to other worlds about the dangers of unchecked resource extraction. This cautionary tale could save countless lives and prevent similar ecological disasters elsewhere.

As you collect the crystalline object from the platform, you feel the weight of responsibility. The beings of Xilica paid a terrible price - their sacrifice must not be in vain.

You carefully secure the archive in your suit's protected storage compartment, ready to present it to the research consortium when your shuttle returns.

Before you leave, you take one last look at the sanctum, silently promising that the true story of this world will be told.

    *** You have chosen to use Xilica as a warning for other worlds ***

Would you like to RESTART, RESTORE a saved game, QUIT or UNDO the last command?